"a" = (/turf/space,/area)
"b" = (/turf/station/r_wall,/area)
"c" = (/obj/begin,/turf/station/floor,/area/start)
"d" = (/obj/window{tag = "icon-window (NORTH)"; icon_state = "window"; dir = 1},/obj/window{tag = "icon-window (WEST)"; icon_state = "window"; dir = 8},/turf/station/r_wall,/area)
"e" = (/obj/window,/obj/window{tag = "icon-window (NORTH)"; icon_state = "window"; dir = 1},/turf/station/r_wall,/area)
"f" = (/obj/window{tag = "icon-window (NORTH)"; icon_state = "window"; dir = 1},/turf/station/r_wall,/area)
"g" = (/obj/window{tag = "icon-window (EAST)"; icon_state = "window"; dir = 4},/obj/window{tag = "icon-window (NORTH)"; icon_state = "window"; dir = 1},/turf/station/r_wall,/area)
"h" = (/obj/window{tag = "icon-window (EAST)"; icon_state = "window"; dir = 4},/obj/window{tag = "icon-window (WEST)"; icon_state = "window"; dir = 8},/turf/station/r_wall,/area)
"i" = (/turf/station/floor,/area)
"j" = (/obj/machinery/light,/turf/station/floor,/area)
"k" = (/obj/machinery/power/apc{dir = 1; environ_consumption = 0; equip_consumption = 0; light_consumption = 0; name = "North APC"},/turf/station/floor,/area)
"l" = (/obj/window{tag = "icon-window (WEST)"; icon_state = "window"; dir = 8},/obj/window,/obj/window{tag = "icon-window (EAST)"; icon_state = "window"; dir = 4},/turf/station/r_wall,/area)
"m" = (/turf/station/floor{name = "airless plating"; icon_state = "Floor1"; intact = 0; oxygen = 0; n2 = 0; health = 100},/area/arrival/start)
"n" = (/obj/window{tag = "icon-window (WEST)"; icon_state = "window"; dir = 8},/obj/window{tag = "icon-window (EAST)"; icon_state = "window"; dir = 4},/turf/station/r_wall,/area)
"o" = (/obj/machinery/light{tag = "icon-fluorescent (EAST)"; icon_state = "fluorescent"; dir = 4},/turf/station/floor,/area)
"p" = (/obj/window,/turf/station/floor,/area)
"q" = (/obj/machinery/light{tag = "icon-fluorescent (WEST)"; icon_state = "fluorescent"; dir = 8},/turf/station/floor,/area)
"r" = (/obj/window{tag = "icon-window (EAST)"; icon_state = "window"; dir = 4},/turf/station/floor,/area)
"s" = (/obj/a_pipe/heat_exchange_pipe{tag = "icon-he (SOUTHEAST)"; icon_state = "he"; dir = 6},/obj/window{tag = "icon-window (WEST)"; icon_state = "window"; dir = 8},/obj/window{tag = "icon-window (NORTH)"; icon_state = "window"; dir = 1},/obj/lattice,/turf/space,/area)
"t" = (/obj/a_pipe/heat_exchange_pipe{tag = "icon-he (SOUTHWEST)"; icon_state = "he"; dir = 10},/obj/window{tag = "icon-window (NORTH)"; icon_state = "window"; dir = 1},/obj/window{tag = "icon-window (EAST)"; icon_state = "window"; dir = 4},/obj/lattice,/turf/space,/area)
"u" = (/obj/window{tag = "icon-window (WEST)"; icon_state = "window"; dir = 8},/turf/station/floor,/area)
"v" = (/obj/a_pipe/heat_exchange_pipe,/obj/window{tag = "icon-window (WEST)"; icon_state = "window"; dir = 8},/obj/lattice,/turf/space,/area)
"w" = (/obj/a_pipe/heat_exchange_pipe{tag = "icon-he (NORTH)"; icon_state = "he"; dir = 1},/obj/window{tag = "icon-window (EAST)"; icon_state = "window"; dir = 4},/obj/lattice,/turf/space,/area)
"x" = (/obj/a_pipe/junction{tag = "icon-junction (NORTH)"; icon_state = "junction"; dir = 1},/obj/window,/obj/window{tag = "icon-window (WEST)"; icon_state = "window"; dir = 8},/obj/lattice,/turf/space,/area)
"y" = (/obj/a_pipe/junction{tag = "icon-junction (NORTH)"; icon_state = "junction"; dir = 1},/obj/window{tag = "icon-window (EAST)"; icon_state = "window"; dir = 4},/obj/window,/obj/lattice,/turf/space,/area)
"z" = (/obj/a_pipe/manifold{tag = "icon-manifold (EAST)"; icon_state = "manifold"; dir = 4},/obj/window{tag = "icon-window (NORTH)"; icon_state = "window"; dir = 1},/turf/station/floor,/area)
"A" = (/obj/a_pipe{tag = "icon-default (NORTHWEST)"; icon_state = ""; dir = 9},/obj/window{tag = "icon-window (NORTH)"; icon_state = "window"; dir = 1},/obj/a_meter,/turf/station/floor,/area)
"B" = (/obj/a_pipe/vent{tag = "icon-vent (EAST)"; icon_state = "vent"; dir = 4},/turf/station/floor,/area)
"C" = (/obj/a_pipe/divider/valve{tag = "icon-valve0 (EAST)"; icon_state = "valve0"; dir = 4},/turf/station/floor,/area)
"D" = (/obj/a_pipe/manifold{tag = "icon-manifold (NORTH)"; icon_state = "manifold"; dir = 1},/turf/station/floor,/area)
"E" = (/obj/a_pipe/inlet{tag = "icon-inlet (WEST)"; icon_state = "inlet"; dir = 8},/turf/station/floor,/area)
"F" = (/obj/machinery/light{tag = "icon-fluorescent (NORTH)"; icon_state = "fluorescent"; dir = 1},/turf/station/floor,/area)
"G" = (/obj/window{tag = "icon-window (WEST)"; icon_state = "window"; dir = 8},/obj/window,/turf/station/r_wall,/area)
"H" = (/obj/window{tag = "icon-window (NORTH)"; icon_state = "window"; dir = 1},/obj/window,/turf/station/r_wall,/area)
"I" = (/obj/window,/obj/window{tag = "icon-window (EAST)"; icon_state = "window"; dir = 4},/obj/a_pipe/vent{tag = "icon-vent (EAST)"; icon_state = "vent"; dir = 4},/turf/station/r_wall,/area)

(1,1,1) = {"
aaaaaaaaaaabcba
adeeeeeeeeefega
ahiijiikiijlmna
ahiiiiiiiiiiina
ahoiippiiiiiqna
ahiirstuiiiiina
ahiirvwuiiiiina
ahiirvwuiiiiina
ahiirxyuiiiiina
ahiiizAiiiiiina
ahoBCDCEiiiiqna
ahiiiiiiiiiiina
ahiiFiiiiiFiina
aGHHHHHHHHHHHIa
aaaaaaaaaaaaaaa
"}
